10100101010010101010
11000100010010010010
10110010010010010100
00100101001000100100
00101010010001010101
10101000010101000000
01001010100101001001
00001001001000010100
11010000100001001001
00000100010000000100
01001001010001000100
11001001010101001010
00100100010001010010
01010010000010100100
00010111010010110001
11010010010000100001
01000100100100100010
01001000010101010000
10010001000010100100
00101010101010001001